R 640 480

NO  ./img/xp1.xpm
SO ./img/cartoon.xpm
EA ./img/bricks.xpm
WE ./img/xp4.xpm
S  ./img/barrel.xpm

C 0,0,0
F 255,255,255


        1111111111111111111111111
        10000000001110000000000011111111111
        1011000001110020000000001
        1001000000000000000000001
111111111011000001110000000000001
100000000011000001110111110111111
11110111111111011100000010001
11110111111111011101010010001
1100000011010101110000001020111111111111111111111111111111111111111111111111111111111111111111111111
100020000000000011000000000000000000000000000000000000000000000000000000000000000000000010001111111111111
10000000000000001101010000000000000E00000000000000000000000000000000000000002000000000000000000100100000111
100000011101010111110111111111100000000000000000000000000000000000000000000000002000000000111111111111111
11110111 1110101 101111010201111111111111111111111111111111111111111111111111111111111111111
11111111 1111111 1111111111111
