R 800 600

NO ./img/xp1.xpm
SO ./img/cartoon.xpm
EA ./img/bricks.xpm
WE ./img/xp4.xpm

S ./img/barrel.xpm

C 22,23,147
F 100,255,25




        1111111111111111111111111
        10000000001110000000000011111111111
        1011000001110020000000001
        1001000000000000000000001
111111111011000001110000000000001
100000000011000001110111110111111
11110111111111011100000010001
11110111111111011101010010001
11000000110101011100000012201
10002000000000001100000012001
10000000000000001101010010201
10000001110101011111011112E2111
11110111 1110101 101111010201
11111111 1111111 111111111111
